NO textures/wolfenstein/blue_stone.xpm
EA textures/wolfenstein/color_stone.xpm
SO textures/wolfenstein/grey_stone.xpm
WE textures/wolfenstein/purple_stone.xpm

C 35,19,73
F 0,100,0

111111111111111
11111100011111011
111110000011111
1111000N0001111
111000000000111
110000000000011
100001111100001
100001110000011
111000010000111
111100000001111
111110000011111
111111000111111
111111111111111
