NO textures/new/wall_1.xpm
EA textures/new/wall_2.xpm
SO textures/new/wall_3.xpm
WE textures/new/wall_4.xpm

C 200,10,73
F 0,100,24

111111111111111
11111100001111011
111110000011111
1111000N0001111
  111000000000111
110000000000011
100001111100001
111111111111111
100001110000011
111000010000111
1111000000011 11
111110000011111
111111000111111
111111111111111