NO textures/wolfenstein/grey_stone.xpm
SO textures/wolfenstein/purple_stone.xpm
WE textures/wolfenstein/red_brick.xpm
EA textures/wolfenstein/wood.xpm


F 220,100,0
C 225,30,0

  11111111111
  1001
  10110010011
  111100S0001
  11110000001
1111111111111

1111111111111
1111111100111
1111111111111