NO textures/wolfenstein/blue_stone.xpm
EA textures/wolfenstein/color_stone.xpm
SO textures/wolfenstein/grey_stone.xpm
WE textures/wolfenstein/purple_stone.xpm

C 35,19,73
F 0,100,20


11111111111
10000000001
10000000001
10E00000001
10000000001
10100000001
10100000001
11111111111