NO textures/wolfenstein/purple_stone.xpm
EA textures/wolfenstein/purple_stone.xpm
SO textures/wolfenstein/grey_stone.xpm
WE textures/wolfenstein/grey_stone.xpm

F      17,    38,     64
C      17,    50,     64


11111111
  10N01
   1W0001
11111111
