NO textures/wolfenstein/purple_stone.xpm
EA textures/wolfenstein/purple_stone.xpm
SO textures/wolfenstein/grey_stone.xpm
WE textures/wolfenstein/grey_stone.xpm

F      17,    38,     64
C      17,    50,     64

1111111111
 1N0010101
111001111
10001  111
11111