NO textures/wolfenstein/purple_stone.xpm



EA textures/wolfenstein/purple_stone.xpm
SO                       textures/wolfenstein/grey_stone.xpm
WE textures/wolfenstein/grey_stone.xpm

F      17,    38,     64
C      17,    50,     64

11111111111111
     1E0010101
111001111
11101
10001  1111111
1111
1